1111111111111111111111111111111111
100000000000000C00000C0000000000P1
1010010100100000101001000000010101
1010010010101010001001000000010101
100000Z00C00C00000000Z000Z000Z00C1
100000000000000C00000C0000000Z0001
101001010010000010100100Z000010101
1010010010101010001001000000010101
100000000C00C0000000000000000000C1
100000Z00000000C00000C000000000001
1010010100100000101001000000010101
1010010010101010001001000000010101
100000000C00C00000000000000Z0000C1
100000000000000C00000C000000Z00001
1010010100100000101001000000010101
1010010010101010001001000000010101
100000000C00C0000000000000000000C1
100000000000000C00000C0000000Z0001
1010010100100000101001000000010101
1010010010101010001001000000010101
100000000C00C00000000000000E0000C1
1111111111111111111111111111111111