111111111111111111111
1E00C0000000000C00001
1000000000000000000P1
100000000000000Z000C1
100Z00000C00000Z0C001
111111111111111111111